21,21,21,21,21,21,21,21,21,21,21,21,21,21,21,21,21,00,00,00,00,00,24,00,00
21,21,21,21,21,21,21,21,21,21,21,21,21,21,21,21,21,00,00,24,24,24,24,00,00
00,24,00,00,00,21,00,00,00,00,00,21,00,00,00,00,00,00,24,24,00,00,00,00,00
00,24,24,24,00,21,00,00,24,24,00,21,00,00,00,00,05,04,04,04,04,04,04,04,04
00,00,05,05,00,21,00,00,24,24,00,21,00,00,00,00,05,15,09,09,09,09,09,09,09
00,05,05,05,00,21,00,00,24,24,00,21,00,00,00,00,05,22,00,00,21,21,00,00,00
00,05,00,05,05,21,00,00,00,00,00,21,00,00,00,00,05,22,00,00,21,21,00,00,00
00,00,05,04,05,21,21,21,21,21,21,21,00,00,00,00,25,22,00,00,00,00,00,00,00
00,00,05,05,00,00,00,00,00,00,00,04,08,08,07,00,25,14,13,13,13,13,13,13,13
00,00,04,00,00,00,00,00,00,00,00,04,08,08,07,00,00,00,00,00,00,00,00,00,00
00,00,04,04,04,04,00,00,00,00,00,00,00,00,00,00,00,00,00,00,00,00,00,00,00
00,00,00,04,04,04,04,00,00,25,21,21,21,21,21,21,21,00,00,24,00,00,24,00,00
00,00,00,04,04,04,04,04,00,25,21,00,00,27,00,00,21,00,00,24,24,00,00,00,00
00,00,08,08,08,08,08,04,25,25,21,00,27,00,27,00,21,00,00,00,24,00,00,00,00
00,00,08,08,08,08,08,00,25,00,21,00,00,27,00,00,21,00,00,00,24,24,00,00,00
00,00,08,08,08,08,08,00,25,00,21,21,21,21,21,21,21,00,00,00,00,24,24,00,00
00,00,08,08,08,08,08,00,00,00,00,00,00,00,00,00,00,00,25,25,25,00,00,00,00
00,00,00,00,00,00,00,00,00,00,00,00,25,25,25,25,25,25,25,00,00,00,00,00,00
